1100000001
0100000001
0111111111
0100000001
0111111110
0000000000