10011111
10000001
11111101
10000001
11111111